BM20808MODE
. . . . . . . .
. T . . . . . .
. . C . . X . .
. . . . . X . .
. . . . C . . .
. . C . . X T .
. . . . C . . .
. . . . . . . .
