BM20808OE
. . . . . . . .
. . . . C . . .
. . . . X . . .
. . . X . . . .
. . . X . . . .
. . . X . . . .
. . . C . . . .
. . . . . . . .
