BM20808OE
. . . . . . . .
. . . . . . . .
. . X X X . . .
. . . . . . . .
. . . X . . . .
. . C . C . . .
. . . . . . . .
. . . . . . . .
