BM20808OE
. . . . . . . .
. . . . C . . .
. . . C . . . .
X X . . . X X X
. . X . . . . .
. . . . . . . .
. . . . . . . .
. . . . . . . .
