BM20808OE
. . . . . . . .
. . . . . . . .
. . . C . . . .
. . . X . . . .
. . . C . . . .
. . X . X . . .
. . . . . . . .
. . . . . . . .
