BM10808
. . . . . . . .
. . . X . . . .
. C . . . . . .
. . . . . . . .
X . . C . . . .
. . . . . . . .
. . . . C C . .
. X . . . . . .
