BM10808
. . . C . . . .
. . . X . . . .
. . . . . . . .
. X C . . X . .
. . . X . . . .
. . . . . X . .
. . . . C . . .
. . . . . . . .
