BM10808
. . . . C C . .
. . . . . . . .
. . X . X . X .
. . X X X . X .
. . X . X . X .
. . . . . . . .
. . . . C C . .
. . . . . . . .
