BM10808
. . . . . . . .
. . . . X . . .
. . . X . . . .
X . C . X . . .
. . . X . . . .
. . . . . . . .
. C X . . . . .
C C . . . . . .
