BM10808
. . X . C . . .
. . . . . . C .
. . . . . . . .
. . . . . . . .
. . C . . . . .
. . . . . . . .
. . C . . . . .
. . . . . X . .
