BM10808
. . . . . . . .
. . . . . . . .
. . C X . . . .
. C . . X . . .
. X . X . . C .
. . X . . . X .
. . . . . C X .
. . . . . . . .