BM10808
. . . . . . . .
. . . . . . . .
X . . . . . X .
. X . . . X . .
. . X C X . C .
. . . X . . . .
. . . C . . C .
. . . . . . . .