BM10808
. . . . . . . .
. . . . . . . .
. . X . . . . .
. . . . . . . .
X . C . X . . C
. . . . . . . .
. . X . . . . .
. . . . . . . .