BM10808
. . . . . . . .
. . X . X . . .
. . . . . . . .
. . C . . . C .
. . X . . . X .
. . C . . C X .
. . . X X . . .
. . . . . . . .