BM10808
. X C . . . . .
. . . . . . . .
X . . X . . . .
. . . C . X . .
. X X . . . X .
. . . C . . C .
. . . . . . . .
. . . . . . . .