BM10808
. . . . . . . .
. . . . . . . .
. . . C . . . .
. . X . X . . .
. X . . . X . .
. . X . X . . .
. . . C . . . .
. . . X . . . .
