BM10808
. . . . . . . .
. . . . . X . .
. . C . . . X .
. . . X . X . .
. . . C C . X .
. . . . . X . .
. . C . . . X .
. . . . . . . .