BM10808
. . . . . . . .
. . . . . . X .
. . . C . . . .
. . . . X . X .
. X . C . C . .
. C X . . . . .
. X . . . . . .
. . . X . . . .