BM10808
. . . . . . . .
. . . . . . . .
. . X . . X . .
. . . C C . X .
. . C . . C . .
. . X . . X . .
. . . X X . . .
. . . . . . . .