BM10808
. . . . . . . .
. . . . . . . .
C . . C . . C .
X . X . X . X .
. . . X . . . X
X . X . X . X .
. . . . . X . .
. . . C . . . .