BM10808
. . . X . . . .
. . . . . . . .
. C . . . C . .
. X . . . X . .
. . X . X . . .
. . . X . . . .
. C . . . C . .
. . . X . . . .