BM10808
. X . . . . . .
X C X . X . . .
. . X . . C . .
C . . . . . . .
. . . X . . . .
. . . . . . . .
. . . . . X . .
. . . . C . . .
