BM20808E
T T T T T T T T
T T T T T T T T
T T T X X T T T
T T T X T T T T
T T T X T T T T
T T T . T T T T
T T T C T T T T
T T T T T T T T
