BM20808MODE
. . C . . . . .
. . . . X . . .
. X . . X . . .
. . . X . . C .
. . . . . . . X
. . X . . X . .
. C . C . . . .
. . . . . . . .