BM20808OE
. . . . . . . .
. . . . . . . .
. . . C X . . .
. . . X . . . .
. . . C . . . .
. . X . X . . .
. . . . . . . .
. . . . . . . .
